level0
0000000G000000000000000000000000000000000000000000000000000000000000000000000000&0000000000000000000000000000000000000000000000000000000000000000000000000000000
00000GGD000000000000000000000000000000000000000000000000000000000000000000000000&P000000000000000000000000000000000000000000000000000000000000000000000000000000
GGG00DDD000000000000000000000000000000000000000000000000000000000000000000000000&0000000000000000000000000000000000000000000000000000000000000000000000000000000
DDD00DDD000000000000GGG000000000000000000000000000000000000000000000000000000000&0000000000000000000000000000000000000000000000000000000000000000000000000000000
DDD00DDD000000000000DDDG00000000000000000000000000000000000000000000000000000000&0000000000000000000000000000000000000000000000000000000000000000000000000000000
DDD00DDD000000000000DDDDGG000000000000000000000000000000000000GGGGGG0000000GGGGG&0000000000000000000000000000000000000000000000000000000000000000000000000000000
DDD00DDD000000000000DDDDDDG00000000000000000000000000000000000DDDDD00000000DDDDD&0000000000000000000000000000000000000000000000000000000000000000000000000000000
00000000000000000000DDDDDDDG0000000000000000000000000000000000DDD0D00000000DD0D0&0000000000000000000000000000000000000000000000000000000000000000000000000000000
0000000000000000G000DDDDDDDD000000000000000000000000000000GGG0D0D00000000000D000&00M0000000000000000000000000000000000000000000000000000000000000000000000000000
GGGGGGGGGGGGGGGGD000DDDDDDDD0000000000000000000000000000000000000000000000000000&0000000000000000000000000000000000000000000000000000000000000000000000000000000
DDDDDDDDDDDDDDDDD000DDDDDDDDG000000000000000000000000000000000000000000000000000&0000000000000000000000000000000000000000000000000000000000000000000000000000000
DDDDDDDDDDDDDDDDD000DDDDDDDDD000000000000000000000000000000000000000000000000000&0000000000000000000000000000000000000000000000000000000000000000000000000000000
DD0DDDD0000000DDD000DDDDDDDDD000000000000000000000000GGG000000000000000000000000&0000000000000000000000000000000000000000000000000000000000000000000000000000000
D000D0D0000000000000DDDDDDDDD000000000000000000000000000000000000000000000000000&0000000000000000000000000000000000000000000000000000000000000000000000000000000
000000000G0000000000DDDDDDDDDG00000000000000000000000000000000000000000000000000&0000000000M00000000000000000000000000000000000000000000000000000000000000000000
000000000DGGGGGGGGGGDDDDDDDDDD00000000000000000000000000000000000000000000000000&0000000000000000000000000000000000000000000000000000000000000000000000000000000
000000000DDDDDDDDDDDDDDDDDDDD00000000000000000000000000000GGG0000000000000000000&0000000000000000000000000000000000000000000000000000000000000000000000000000000
0000000000000DDDDDDDDDDDD0000000000000000000000000000000000000000000000000000000&0000000000000000000000000000000000000000000000000000000000000000000000000000000
GGGGGGG0000000DDDDDDDDD000000000000000000000000000000000000000000000000000000000&0000000000000000000000000000000000000000000000000000000000000000000000000000000
DDDDDDD00000000DDDDDD00000000000000000000000000000000000000000000000000000000000&0000000000000000000000000000000000000000000000000000000000000000000000000000000
DDDDDDD00000000DDDDD00000000000000000000000000000000GGG0000000000000000000000000&0000000000000000000000000000000000000000000000000000000000000000000000000000000
00000000000000GDDDD0000000000000000000000000000000000000000000000000000000000000&0000000000000000000000000000000000000000000000000000000000000000000000000000000
00000000000GGGDDD0000000B00000000G0000000000G00000000000000000000000000000000000&00000M000000000000000000000M000000000000000000000000000000000000000000000000000
000GGGGGGGGDDD000000000000GGGGGGGD0000000000DGG000000000000000000000000000000000&0000000000000000000000000000000000000000000000000000000000000000000000000000000
000DDDDDDDD000000000GG0000DDDDDDDD0000000000DDD00000000000GGG0000000000000000000&0000000000000000000000000000000000000000000000000000000000000000000000000000000
000000000000000000GGDD0000DDDDD0000000000000DDD000000000000000000000000000000000&0000000000000000000000000000000000000000000000000000000000000000000000000000000
00000000000000000GDDDD0000DDD000000000000000DDD000000000000000000000000000000000&0000000000000000000000000000000000000000000000000000000000000000000000000000000
0000000000GG000GGDDDD000000DD00000G000000000DDD000000000000000000000000000000000&0000000000000000000000000000000000000000000000000000000000000000000000000000000
GGGGGGGGGGDD000DDDDDD0000000D00000D000000000000000000GG0000000000000000000000000&0000000000000000000000000000000000000000000000000000000000000000000000000000000
DDDDDDDDDDD0000DDD0D00000000000000DG00000000000000GGGDD0000000000000000000000000&0000000000000000000000000000000000000000000000000000000000000000000000000000000
DD00DDD00D00000DD00D00000000000000DDG0000000000GGGDDDD00000000000000000000000000&00000000000000000000000000000000000000000M0000000000000000000000000000000000000
D0000D0000000000D00000000000000000DDDGGGGGGGGGGDDDDD0000000000000000000000000000&0000000000000000000000000000000000000000000000000000000000000000000000000000000
0000000000000000000000000000000000DDDDDDDDDDDDDDDD000000000000000000000000000000&0000000000000000000000000000000000000000000000000000000000000000000000000000000
000000000000000000000000000000000000DDDDDDDDDDDD00000000000000000000000000000000&0000000000000000000000000000000000000000000000000000000000000000000000000000000
00000000000000000000000000000000000000000DDDDD0000000000000000000000000000000000&0000000000000000000000000000000000000000000000000000000000000000000000000000000
00000000000000000000000000000000000000000000000000000000000000000000000000000000&0000000000000000000000000000000000000000000000000000000000000000000000000000000
00000000000000000000000000000000000000000000000000000000000000000000000000000000&0000000000000000000000000000000000000000000000000000000000000000000000000000000
00000000000000000000000000000000000000000000000000000000000000000000000000000000&0000000000000000000000000000000000000000000000000000000000000000000000000000000
00000000000000000000000000000000000000000000000000000000000000000000000000000000&0000000000000000000000000000000000000000000000000000000000000000000000000000000
00000000000000000000000000000000000000000000000000000000000000000000000000000000&0000000000000000000000000000000000000000000000000000000000000000000000000000000
00000000000000000000000000000000000000000000000000000000000000000000000000000000&0000000000000000000000000000000000000000000000000000000000000000000000000000000
00000000000000000000000000000000000000000000000000000000000000000000000000000000&0000000000000000000000000000000000000000000000000000000000000000000000000000000
00000000000000000000000000000000000000000000000000000000000000000000000000000000&0000000000000000000000000000000000000000000000000000000000000000000000000000000
00000000000000000000000000000000000000000000000000000000000000000000000000000000&0000000000000000000000000000000000000000000000000000000000000000000000000000000
00000000000000000000000000000000000000000000000000000000000000000000000000000000&0000000000000000000000000000000000000000000000000000000000000000000000000000000
